 #  #  #  #  #  #  #  #  #  #           #     #           #  #  #  #  #  #  #  #  #  #  #  #
 #  .  .  @  .  .  .  .  .  #           #     #           #  .  .  .  .  #  #  .  .  .  .  #
 #  .  #  #  #  .  #  #  .  #           #     #           #  .  #  #  .  #  #  .  #  #  .  #
 #  .  #     #  .  #  #  .  #           #     #           #  .  #  #  .  .  .  .  #  #  .  #
 #  .  #     #  .  #  #  .  #           #     #           #  .  #  #  #  #  #  .  #  #  .  #
 #  .  #  #  #  .  #  #  .  #  #  #  #  #     #  #  #  #  #  .  #  #  #  #  #  .  #  #  .  #
 #  .  .  .  .  .  .  .  .  .  .  .  .  .  .  .  .  .  .  .  .  .  .  .  .  .  .  #  #  .  #
 #  .  #  #  #  .  #  #  #  #  #  #  #  #     #  #  #  #  #  .  #  #  .  #  #  #  #  #  .  #
 #  .  #     #  .  #  #  #  #  #  #  #  #     #  #  #  #  #  .  #  #  .  #  #  #  #  #  .  # 
 #  .  #     #  .  .  .  .  #  #                       .  .  .  #  #  .  .  .  .  #  #  .  #
 #  .  #     #  .  #  #  .  #  #     #  #  #  #  #     #  #  .  #  #  .  #  #  .  #  #  .  #
 #  .  #  #  #  .  #  #  .  #  #     #           #     #  #  .  #  #  .  #  #  .  #  #  .  #
 #  .  .  .  .  .  #  #  .  .  .     #           #     #  #  .  .  .  .  #  #  .  .  .  .  #
 #  #  #  #  #  .  #  #  #  #  #                 #     #  #  #  #  #  .  #  #  #  #  #  .  #
 #  #  #  #  #  .  #  #  #  #  #                 #     #  #  #  #  #  .  #  #  #  #  #  .  #
 #  .  .  .  .  .  #  #  .  .  .     #           #     #  #  .  .  .  .  #  #  .  .  .  .  #
 #  .  #  #  #  .  #  #  .  #  #     #           #     #  #  .  #  #  .  #  #  .  #  #  .  #
 #  .  #     #  .  #  #  .  #  #     #  #  #  #  #     #  #  .  #  #  .  #  #  .  #  #  .  #
 #  .  #     #  .  .  .  .  #  #                       .  .  .  #  #  .  .  .  .  #  #  .  #
 #  .  #     #  .  #  #  #  #  #  #  #  #     #  #  #  #  #  .  #  #  .  #  #  #  #  #  .  #
 #  .  #  #  #  .  #  #  #  #  #  #  #  #     #  #  #  #  #  .  #  #  .  #  #  #  #  #  .  #
 #  .  .  .  .  .  .  .  .  .  .  .  .  .  .  .  .  .  .  .  .  .  .  .  .  .  .  #  #  .  #
 #  .  #  #  #  .  #  #  .  #  #  #  #  #     #  #  #  #  #  .  #  #  #  #  #  .  #  #  .  #
 #  .  #     #  .  #  #  .  #           #     #           #  .  #  #  #  #  #  .  #  #  .  #
 #  .  #     #  .  #  #  .  #           #     #           #  .  #  #  .  .  .  .  #  #  .  #
 #  .  #  #  #  .  #  #  .  #           #     #           #  .  #  #  .  #  #  .  #  #  .  #
 #  .  .  @  .  .  .  .  .  #           #     #           #  .  .  .  @  #  #  .  .  .  .  #
 #  #  #  #  #  #  #  #  #  #           #     #           #  #  #  #  #  #  #  #  #  #  #  #
